1000000C000000000S0000001


10P001000S100C000000E0001
1111111111111111111111111