1111111111111111111111111
1000000C0000000C000000001
10P001000100C000000E00001
1111111111111111111111111