1111111111111111111111111
1P00000C0000S00C000000001
10S01SSC100C001S000E00001
1111111111111111111111111