1111111111111111111111111
1SS0000C00000000000000001
10P00100010SC000000E000S1
1111111111111111111111111