11111111111111111111111111111111111
1110C0000C1C000001000C000001C0001E1
11101S11S01111110101111111C1C110101
111000C10C11111101C100C000011110101
111111110S1111110101011111110000101
1000C00000111111010101SC00S10110101
1C11110111111S0C0101C1SSS0S1011C101
101C110111111C010101011110110111101
1P1000C0000C00S100010000C0000000001
11111111111111111111111111111111111