1111111111111111111111111
1000000C00000000000000001
10P0010000100C000000E0001
1111111111111111111111111