11111111111111111111111111111111111
1110C0000C1C000001000C000001C0001E1
11101111C01111110101111111C1C110101
111000C10C11111101C100C000011110101
11111111001111110101011111110000101
1000C0000C1111110101011111110110101
1C1111011111100C0101C1111111011C101
101C110111111C010101011111110111101
1P1000C0000C000100010000C0000000001
11111111111111111111111111111111111